wwwwwwwwwwwwww
w------------w
w-----ww-----w
w-----ww-----w
w-----ww-----w
w-----ww-----w
w-----ww-----w
------ww------
------ww------
--------------
wwwwwwwwwwwwww