wwwwwwwwwwwwww
w-----ww-----w
w-----ww-----w
w--w--ww--w--w
w--w--ww--w--w
w--w--ww--w--w
w--w--ww--w--w
---w--ww--w---
---w------w---
---w------w---
wwwwwwwwwwwwww